#####################
#A    #######       #
# ### #     #########
# #   # ###         #
# # ### # ######### #
# #   # # #     #   #
# ### ### ### # ### #
#   #     #   #     #
##### ######### #####
#   #       #       #
# # ####### ####### #
# #       #         #
# ### ### ### ### # #
#     #   #     #   #
# ##### ####### #####
#       #     #     #
##### ########## ####
#   #               #
# # ####### #########
# #                 #
# ################# #
#B                  #
#####################
