#####################
#A                  #
# ##### #############
#     #             #
# ### # ### #########
# #   # #   #       #
# # ### # ### ##### #
# #     #     #     #
# ##### ########### #
#     #             #
####### #  #########
#     # #   #       #
# ### # ### ####### #
#   #   #     #     #
# ### ### ####### ###
#     #   #         #
##### ########## ####
#       #           #
# ##### #############
#                   #
################### #
#B                  #
#####################
